12 10
# # # # # # # # # # # #
# . # . . . . . . . . #
# . # . # # # # # # . #
# . # . . . . # . . . #
# . # # # . * # . # . #
# . . . # # # # . # . #
# . # . # . . # . # . #
# . # . # . # # . # . #
# o # . . . . . . # . #
# # # # # # # # # # # #